0000000000000-00000000000000
0...........000............0
0.0.....000.000.000......0.0
0.0......................0.0
0.000.....0.....0......000.0
0..........................0
0.0.....000.....000......0.0
0.........0.....0..........0
0.000.....0.....0......000.0
0..........................0
0.......000......000.......0
0........0........0........0
000......................000
--0.......00000000.......0--
000.........pppp.........000
---.......00000000.......---
000......................000
--0.......00000000.......0--
000......................000
0........0.......0.........0
0........0.......0.........0
0........0.......0.........0
0.0.....000.000.000......0.0
0.0......................0.0
0.000.....0.....0......000.0
0..........................0
0.0.....000.....000......0.0
0.........0.....0..........0
0.000.....0.....0......000.0
0..........................0
0000000000000000000000000000
